25
15
0 0 0 0 0 0 0 0 0 0 0 0 0 0 0 0 0 0 0 0 0 0 0 0 0
0 19 0 19 26 26 26 30 0 19 26 22 0 19 26 18 26 26 18 26 18 26 26 22 0
0 21 0 21 0 0 0 0 0 21 0 21 0 21 0 21 0 0 29 0 21 0 0 21 0
0 24 26 16 26 26 26 18 26 20 0 17 18 28 0 25 28 0 0 0 21 0 0 21 0
0 0 0 21 0 0 0 21 0 25 18 24 20 0 0 0 17 18 26 26 24 22 0 0 0
18 22 0 17 26 22 0 21 0 0 21 0 21 0 19 18 26 24 20 0 0 0 29 0 19 18
16 20 0 21 0 25 18 20 0 0 17 21 20 0 21 0 0 17 26 22 0 0 0 17 16
16 16 26 20 0 0 17 16 26 26 28 0 25 18 28 0 27 20 0 17 26 18 26 16 16
16 20 0 21 0 19 24 20 0 0 0 0 0 21 0 0 0 21 0 21 0 21 0 17 16
24 28 0 17 26 28 0 21 0 19 26 18 26 24 22 0 19 28 0 17 26 20 0 25 24
0 0 0 21 0 0 0 16 26 20 0 21 0 0 16 26 20 0 27 20 0 21 0 0 0
0 18 26 24 26 18 26 28 0 21 0 16 26 26 28 0 21 0 0 21 0 25 26 22 0
0 21 0 0 0 21 0 0 0 21 0 21 0 0 0 0 21 0 0 21 0 0 0 21 0
0 25 26 26 26 24 26 30 0 25 26 24 26 30 0 27 24 26 26 24 26 26 26 28 0
0 0 0 0 0 0 0 0 0 0 0 0 0 0 0 0 0 0 0 0 0 0 0 0 0